Customer,Sq. Feet,Stairs,Distance from base (miles),Bathrooms,Hardwood Sq. ft,Carpet Sq.  Ft,Windows
1,2500,1,0.3,3,800,1700,
2,2270,1,0.5,3,2000,270,
3,3400,1,0.4,3,1000,2400,
4,3000,1,0.4,3,2000,1000,
5,2270,1,0.4,3,1900,370,
6,2550,0,0.4,1,2000,550,
7,2550,2,0.3,3,2000,550,
8,2900,2,0.3,4,200,2700,
9,3200,1,0.3,3,1500,1700,
10,2500,1,0.3,3,2000,500,
